111111111111111111111111
11111100000C000000000001
10000000000000000C011111
111111100000000000000011
100001111010111000000111
100000001P00000000000E11
111111111111111111111111
