111111111111111111111111
11111100000C000000000001
10000000000000000C011111
111111100000000000000011
100001110000111000000111
100000000P000000000C0E01
111111111111111111111111
