111111111111111
1WUUUUUUUUUUUA1
1LP0000C000S0R1
1L0S0000000C0R1
1L00000S00000E1
1L000S0000000R1
1LD00000000S0R1
1L0C0S0000C00R1
1KBBBBBBBBBBBJ1
111111111111111
111111111111111