2T1T111111111T2
2AEA02D000000C2
200002000C00002
201111000022002
20000C000A22CA2
2C0000001111112
2C000C0000C00A2
220d000002222C2
21000C000111102
2A0C00000C0CCP2
333333333333333