111111111111111
1C0D00B000C0011
1R000100B000101
11110000000S1E1
1000010B001C101
1C000R001111101
1B00000CS000R01
1000S00000B0001
111111000111101
1SP00000R00CB01
111111111111111