111111111111111
10S000D000S0111
1SE001000000C11
111100000S00001
1C00010000C0S01
1C000S001111101
1C0d0C0000C0001
1000000S00000C1
10S000000111101
100CC00S0CSCCP1
111111111111111