111111111111111111111111
11C00010100E000000000001
10P100000000000000000001
1000000000000000000D0001
11C100001000000000000001
111111111111111111111111