1111111111
11C0001011
10P00E0001
1010000001
11C10000D1
1111111111