111111111111111111111111
11C00010101E1000000D0001
10P100000000000000000001
10000000000000000000D001
11C1000010000D0000000001
111111111111111111111111