111111111111111111111111111111
11C000100000000000000000000001
1P000E000000000000000000000001
100000000000000000000000000001
11C100000000000000000000000001
111111111111111111111111111111