111111111111111111111111
11C00010101E1000001C1001
10P100000001000000000001
100000000000000100000001
11C100001000000000000001
111111111111111111111111