111111111111111111111111
11C00010100E0000000D0001
10P100000000000000000001
100000000000000000000001
11C100001000000000000001
111111111111111111111111