1111111111
11C0001011
10P10E0001
1000000001
11C1000011
1111111111