111111111111111
1P0000000000101
100001000000101
111100000010101
1C0001000010101
1C0000001111101
1C000C000000001
1000000000000C1
111111000111101
100CCCC00C0CCE1
111111111111111